NO textures/colors.xpm
SO textures/colors.xpm
WE textures/colors.xpm
EA textures/colors.xpm

F 60,10, 22
C 225, 0, 127

111111111111111111111111111
1E0000000000000000000000001
100000100100000111110000001
100000100100001000010000001
100000100100000000110000001
100000111110000001100000001
100000000100000011000000001
100000000100001111111000001
100000000000000000000000001
111111111111111111111111111
