NO textures/animals.xpm
SO textures/animals.xpm
WE textures/animals.xpm
EA textures/animals.xpm

F 60, 50, 50
C 20, 20, 50

111111111111111111111111111
1E0000000000000000000000001
100000000000000000000000001
100000000000000000000000001
100000000000000000000000101
100000000000000000000010101
111111101111111111101010101
100000101000000001001010101
101110101011111101101110101
100000100010000100000010001
101111111011111111111110111
100000000010000000000000001
101111111111111111111111101
100000000000000000000000001
101111111111111111111110101
100010000000000000000010001
101010111011111111110110111
100000000010000000000010001
101111101111111111111110101
100000100000000000000010001
101111101111111111111111101
111111111111111111111111111