NO textures/wall_tex2.xpm
SO textures/wall_tex2.xpm
WE textures/wall_tex2.xpm
EA textures/wall_tex2.xpm

F 30, 30, 30
C 50, 50, 50

1111111111111111111111111
1E00000000000000000000001
1D11111111111111111111101
1000000000000000000000101
1011111110011111111100101
1010000010100000000100101
1010111110111111100101101
1010100000000000100000101
101010111011D110101110101
1000100010000010100010101
1011111110111011111011101
1000000000100000000000001
101111111111D111111111101
1000000000000000000000101
10111D1111111D11111100101
1000100000000000000000101
1011101110111111111111101
1000001000000000000000001
1011111011111111111111101
1111111111111111111111111